@@@@@@@.....@@@@@@@@
@@@@@@@@@.@@@@@@@@@@
@@@@@@@@@.@@@@@@@@@@
@@@@@@@@@.@@@@@@@@@@
G@@@@@@.....@@@@@@@@
####################
~~~~~~~~~~~~~~~~~~~~
~~~~~~~~~~~~~~~~~~~~