...@@@..@@@.................................@
...@....@..@................................@
...@.@@.@..@................................@
...@..@.@..@................................@
...@@@@.@@@....................#.....#......@
..........................#....#.....#......@
G....#####AAAA.......#....#....#.....#......@
######~~~#############~~~~#~~~~#~~~~~#~~~~~~@
############################################@
############################################@
############################################@
############################################@